#|#|@|@|@|@|@|@|@|@|@|@|@|#|#|#
#|#|@|@| | | | | | | |*|@|#|#|#
#|#|#|#|@| | |@|@|@| | |@|@|#|#
#|#|#|#|@| | | | | | | | | |@|#
#|#|#|@| | | | | | | | | |@|#|#
#|#|@| | | | | | | | | | | |@|#
@|@| | | | |@| | |B1| | |@|@|#|#
@| | |*| | | | | | |B0| |@|#|#|#
@| | | |@|@|@|@|@| | | |@|#|#|#
@| | | |@|#|#|#|@| | |M|@|#|#|#
#|@|@|@|#|#|#|#|#|@|@|@|#|#|#|#
#|#|#|#|#|#|#|#|#|#|#|#|#|#|#|#